 ###########################################################
                                                           #
# ################ ## ################ ## ################ #
# #              # ## #              # ## #              # #
# # ############ # ## # ############ # ## # ############ # #
# #   #        # # ## #   #        # # ## #   #        # # #
# ### # ######## # ## ### # ######## # ## ### # ######## # #
#                 .                   .                   .#
##################.###################.###################.#
#                  ##                  ##                  #